Tradução durante o vídeo 

I can talk about my skills and abilities = Posso falar sobre minhas habilidades e habilidades

So, Guanabara. Let's talk about our skills? = Então, Guanabara. Vamos falar sobre nossas habilidades?

to can = para poder

Afifirmative = Afirmativa 
I can = Eu posso
You can = você pode
He can = ele pode
She can = ela pode 
It can = pode
We can = pudermos
They can = eles podem 

Negative = Negativa 
I can't = Não posso
You can't = você não pode 
He can't = Ele não pode 
She can't = Ela não pode 
It can't = não pode
We can't = não podemos
They can't = eles não podem

Interrogative = Interrogativa 
Can I.. = Posso..
Can you.. = Você pode..
Can he.. = Ele pode..
Can she..= Ela pode..
Can it.. = Será que pode..
Can we.. = Podemos..
Can they.. = Eles podem.

Vebs to describe skills = Verbos para descrever habilidades

Dance = Dança                   Play the guitar = Tocar violão 
Draw = Empate                   Sing = Cantar
Fix things = Consertar as coisas Skeateboard = Skate
Read music = Faixa de musica 	Snowboard = Prancha de snowboard
Paint = Arte 			Speak two languages = Fala dois idiomas
Surf				Swin = Nadar

I can dance. = 	Eu posso dançar.	I can't surf = não consigo surfar

Can x Be able to = Pode x Ser capaz de

I'm not able to swim Today = Não consigo nadar hoje

Atividade do final do video 

1- He can dance = Ele sabe dançar 

2- I can play the guitar = Eu sei tocar violão

3- They can speak two languages = Elas podem falar duas línguas 
