01/27/2025

Tradução durante o video 

I can talk about work = Eu posso falar sobre o trabalho 

What activities can you do in a happy office? = Que atividades você pode realizar em um escritório feliz?

Vocabulary: Work = Vocabulários Trabalho
Campany = Campânia
Workers = Trabalhadoras(o)
Office = Escritório
Work hard = Trabalhe duro
Have a meeting = Faça uma reunião
Think = Pensar
Take a break = Faça uma pausa
Your coworkers = Seus colegas de trabalho

I work for a big American company = Eu trabalho para uma grande empresa americana

I have a new desk and a chair in my office. = Tenho uma nova mesa e uma cadeira em meu escritório.

She's a very good worker = Ela é uma trabalhadora muito boa

It's time to take a break and have a cup of caffee = É hora de fazer uma pausa e tomar uma xícara de café

I work in a team with six cowokers = Eu trabalho em uma equipe com seis colegas de trabalho

We're always busy. We work hard = Estamos sempre ocupados. Nós trabalhamos duro

Can we have a meeting? = Podemos ter uma reunião?

I don't know the answer. Can I think about it for five minutes? = Eu não sei a resposta. Posso pensar nisso por cinco minutos?

Atividade do final do video? 

1-A workplace, with desks and chairs = Um local de trabalho, com mesas e cadeiras
A- Workers = Trabalhadores 
B- Office = Escritório 

2-The people you work with = As pessoas com quem você trabalha
A- Your cowowkers = Seus colegas de trabalho 
B- Company = Compania

3- Do a lot of work = Trabalhe muito
A-Have a meeting = Faça uma reunião
B-Work hard = Trabalho difícil 


