12/01/2024

Tradução durante o vídeo 

I know how to ask queestions in English = Eu sei fazer perguntas em inglês

Question word + Auxiliary verb + Subject + main verb = Palavra interrogativa + verbo auxiliar + sujeito + verbo principal

Yes, i took a bath = Sim, eu tomei banho de banheira 

Where do you live = Aonde você mora

What do you like about it = O que você gosta nisso

Sunglasses = óculos de sol 

Do you live in América = Você vive na américa

Bill = conta ou fatura 

You can do more = você pode fazer mais 

Open questions = Perguntas abertas 

Who = quem
Where = onde 
When = quando 
What = oque ou qual 
Why = porque ou por que 
How = como 

Closed questions = Perguntas fechadas

Do = fazer
Be = ser
Can = pode
Have = ter 

Exercícios do final  do vídeo 

1- to ask questions 
R: fazer perguntas 

2- Questions & Answers 
R: Perguntas e respostas 

3- Where 
R: onde
