11:28:2024

A or an + abjective + noun = A ou an + abjetivo + substantivo

An old lady = Uma velha senhora 

A Young lady = Uma jovem

Noun or pronoun + (be) + adjective = Substantivo ou pronome + (vervo to be) + adjetivo

He is short = Ele é baixo

She is really tal =  Ela é realmente alta

Six adjectives of personality = Seis adjetivos de personalidade

Boring = tedioso

A boring person = Uma pessoa chata

He is really boring = Ele é realmente chato

Friendly = Amigável

I think she is very friendly = Eu acho que ela é muito simpática

Are the people friendly = As pessoas são amigáveis
the = eles

Funny = Divertida

My friend Paula is really funny = Minha amiga Paula é muito engraçada =

He is so funny = Ele é tão engraçado

Interesting = interessante

Paul is a very interesting man = Paul é um homem muito interessante 

Did you meet any interesting peaple = Você conheceu alguma pessoa interessante

Shy = Tímida

She is very shy with adults = Ela é muito tímida com adultos

He was too shy to speak to her = Ele era muito tímido para falar com ela

Smart = Inteligente ou esperta

Do you think I´s smart = Você acha que eu sou inteligente

He is a smart business man = Ele é um homem de negócios inteligente

Exercicios 

Old = Velho

Short = Curto

Interesting = interessante



