12/17/2024

Tradução durante o vídeo 

I know what to expect from this second module = Eu sei o que esperar deste segundo módulo

Module II Bginners = Modulo 2 para iniciantes 

Types of houses = Tipos de casas

Possessive `s and s' = Possessivos 's e s'

Talk about furniture = Fale sobre móveis

Information questions with Be = Perguntas informativas com Be

Offering and accepting things = Oferecendo e aceitando coisas

Simple presente with He, She and They =  Presente simples com Ele, Ela e Eles

Weekdays and weekends activities = Atividades durante a semana e finais de semana

Adverbs of frequecy = Advérbios de frequência

Telling the time = Contando a hora 

Talking about place using 'there' = Falando sobre lugar usando 'lá'

show you agree = mostre que você concorda

Review Countries and nationalities = Revise países e nacionalidades

Talking bout your daily routine = Falando sobre sua rotina diária

Review how to introduce yourself = Review how to introduce yourself

Talk about nature in your área = Fale sobre a natureza em sua área

Review small talk = Revise conversa fiada

Ask for or give directions = Peça ou dê instruções

Count and non-count nouns = Peça ou dê instruções

Useful phrases at home = Frases úteis em casa

Review vocabularies in Module 2 = Revise os vocabulários no Módulo 2

Useful phrases to talk aboout daily activities = Frases úteis para falar sobre atividades diárias

Grammar riview in Module 2 = Revisão gramatical no Módulo 2

Useful phrases to talk about places = Frases úteis para falar sobre lugares 

Functional Language in Module 2 = Linguagem Funcional no Módulo 2

Exercicios do final do Video 

Talk about places in your city = Fale sobre lugares da sua cidade 

Show you agree = Monstre que você concorda 

Talk about nature in your área = Falar sobre a natureza da sua área 