01/04/2025

tradução durante o vídeo 

I've reviwed some vacabularies from module 2 = Revisei algumas vocabulários  do módulo 2

1- Which word does not belong to the categories = Qual palavra não pertence às categorias

A. Technology 
App = Aplicativos 
Laptop = Notebook 
Morning(correto) = Manhã
Phone = telefone 
Tablet = Tablet 

B. Music 
Album = Album 
Band = grupo de banda 
Playlist = Playlist 
Singer = Cantor(A)
Hill(correto) = Colina 

C. Nature 
Grass = grama 
Mountain = Montanha 
River = Rio 
Song(Correto) = som 
Tree = Arvore 

2. Which word does not belong to the categories = Qual palavra não pertence às categorias

A. Places in cities = Lugares nas cidades
Café = 
Hospital = Hospital 
Restaurant = Restaurante 
Run(correto) = correr
Store = loja 

B. Things we do = Coisas que fazemos
Call friends = Chamada com os amigos 
Get up = levantar da cama 
Camera(correto) = Camera 
Play soccer = Jogar futebol 
Work = Trabalho

C. Days and times of the day = Dias e horários do dia
Afeternoon = Tarde 
Hotel(coreto) = Hotel 
Monday = Segunda feira 
Morning = De manha 
Night = noite 

3. Complete the sentence with the correct word = Complete a frase com a palavra correta

A. Excuse ____ . Where's the zoo? = Com licença . Onde fica o zoológico?

turn = vire
way = caminho
me(correto) = com

4. Complete the sentence with the correct word = Complete a frase com a palavra correta

The zoo?

Yes, Is it ____ here? = sim, é perto daqui?

me = com
near(correto) = perto
to = para

5.Complete the sentence with the correct word = Complete a frase com a palavra correta

Yes. It's that ____. = Sim, é desse por ai

whay(correto) = por ai
to = para
me = com

6.Complete the sentence with the correct word = Complete a frase com a palavra correta

Go one block, and then____ left. = Ande um quarteirão e depois vire à esquerda.

way = por ai 
turn(correto) = vire 
near = perto

