12;19;24

Tradução durante o vídeo 

I can talk about my home = Posso falar sobre minha casa

You know it = Você sabe disso 

Where do you live = Aonde você mora 

Me too - eu também 

What's your home like = Como é a sua casa

I live in a house = Eu moro em uma casa

I live in na apartment = Eu moro em um apartamento 

An apartment is a part of a building = Um apartamento faz parte de um edifício(prédio) 

My house has two bedrooms( ou roon), a living room and a ktchen = Minha casa tem dois quartos, uma sala e uma cozinha

My house has two small bedrooms(roon) = Minha casa tem dois quartos pequenos

My house has a living room  with big Windows = Minha casa tem uma sala com grandes janelas

Bathroom x restroom = Banheiro de casa x banheiro Publico

Home sweet home = Lar doce lar 

Adjectives for home = Adjetivos para casa

Small = pequeno 

Spacious = Espaçoso

Cosy = Aconchegante

Light = Iluminada 

Warm or cool = Quentinha ou quentinho 

Warm like hell = Quente como o inferno 

Convenient = Confortável 

                       Exercícios do final do vídeo 

1- Bullding 
R: Prédio ou Edifício 

2- Restroom 
R: Banheiro publico 

3- Cosy 
R: Aconchegante 
